0 0 0 6 2 3 0 0 0 0 0 0 0 0 0 0 0
0 0 0 1 0 1 0 0 0 0 0 6 2 2 3 0 0
2 2 2 7 2 4 0 0 0 0 0 1 0 0 1 0 0
0 0 0 1 0 0 0 0 0 0 0 1 0 0 1 0 0
0 6 2 7 2 2 2 2 2 2 2 4 0 0 1 0 0
0 1 0 1 0 0 0 0 0 0 0 0 0 0 1 0 0
0 5 2 4 0 0 6 2 2 2 2 2 2 2 4 0 0
0 0 0 0 0 0 1 0 0 0 0 0 0 0 0 0 0
0 0 0 0 0 0 1 0 0 0 0 0 0 0 0 0 0
0 0 0 0 0 0 1 0 0 0 0 0 0 0 0 0 0
0 0 0 0 0 0 1 0 0 0 0 0 0 0 0 0 0
0 0 0 0 0 0 1 0 0 0 0 0 0 0 0 0 0
