0 0 0 12 2 3 0 0 0 0 0 0 0 0 0 0 0
0 0 0 1 0 1 0 0 0 0 0 6 2 2 9 0 0
2 2 2 7 2 4 0 0 0 0 0 1 0 0 1 0 0
0 0 0 1 0 0 0 0 0 0 0 1 0 0 1 0 0
0 6 2 7 2 2 2 2 2 2 2 4 0 0 1 0 0
0 1 0 1 0 0 0 0 0 0 0 0 0 0 1 0 0
0 5 2 10 0 0 12 2 2 2 2 2 2 2 10 0 0
0 0 0 0 0 0 1 0 0 0 0 0 0 0 0 0 0
0 0 0 0 0 0 1 0 0 0 0 0 0 0 0 0 0
0 0 0 0 0 0 1 0 0 0 0 0 0 0 0 0 0
0 0 0 0 0 0 1 0 0 0 0 0 0 0 0 0 0
0 0 0 0 0 0 1 0 0 0 0 0 0 0 0 0 0
