0 0 0 0 0 0 0 0 0 0 0 0 0 0 0 0 8
0 0 0 6 2 2 2 2 2 2 2 2 2 2 2 2 2
0 0 0 1 8 8 8 8 8 0 0 0 0 0 0 0 0
0 0 0 1 0 0 0 0 8 0 0 0 0 0 0 0 0
0 0 0 1 0 0 0 0 8 0 0 0 0 0 0 0 0
2 2 2 7 2 a 0 0 8 0 0 0 0 0 0 0 0
0 0 0 1 8 1 0 0 8 0 0 0 0 0 0 0 0
0 0 0 1 0 1 0 0 8 0 0 0 0 0 0 0 0
0 0 0 1 0 1 0 0 0 0 0 0 0 0 0 0 0
0 0 0 5 2 b 0 0 0 0 0 0 0 0 0 0 0
0 0 0 0 0 0 0 0 0 0 0 0 0 0 0 0 0
0 0 0 0 0 0 0 0 0 0 0 0 0 0 0 0 0
