0 0 0 10 5 7 0 0 0 0 0 0 0 0 0 0 0
0 0 0 2 0 2 0 0 0 0 0 10 5 5 7 0 0
5 5 5 11 5 8 0 0 0 0 0 2 0 0 2 0 0
0 0 0 2 0 0 0 0 0 0 0 2 0 0 2 0 0
0 10 5 11 5 5 5 5 5 5 5 8 0 0 2 0 0
0 2 0 2 0 0 0 0 0 0 0 0 0 0 2 0 0
0 9 5 8 0 0 10 5 5 5 5 5 5 5 8 0 0
0 0 0 0 0 0 2 0 0 0 0 0 0 0 0 0 0
0 10 5 5 5 5 8 0 0 0 0 0 0 0 0 0 0
0 2 0 0 0 0 0 0 0 0 0 0 0 0 0 0 0
0 9 5 5 5 5 7 0 0 0 0 0 0 0 0 0 0
0 0 0 0 0 0 2 0 0 0 0 0 0 0 0 0 0
